R 500 500

F 94, 93, 91
C 1, 12, 36

S textures/sprite_3.xpm

NO textures/purplestone.xpm
SO textures/wall_3.xpm
EA textures/eagle.xpm
WE textures/wood.xpm

111111111111111111
1100011111111111111111111
1101111111111111110101001111
1100000011010101110000000001
1000000000000000110000001111
1000000000000000110101001
1100000011010101111101111
 111101111101011111110111
 1111011111110010110000001
1100000111000000110000001
1000002011000000110000001
10000N0011111110111000101
10000000111111111 111001
1100000011100011111000111
1020020010000011010101001
1000000000000000000000001
1020000001000001101010101
1100000111000111111000111
1100001110001  1110001111
1111111111111  1111111111

