R 200 200

F 94, 1, 1
C 1, 12, 36

S textures/sprite_3.xpm

NO textures/purplestone.xpm
SO textures/wall_3.xpm
EA textures/eagle.xpm
WE textures/wood.xpm

111111111111111111111111111111111111111111111111111111111111111111111111111111111111111111111111111111111111111111111111111111111111111111111111111111111111111111111111111111111111111111111111111
100000002222222222222222222222222222201111111111111111111111111111111111111111111111111111111111111111111111111111111111111111111111111111111111111111111111111111111111111111111111111111111111111111111111111111111111111111111111111111
10000001111111111111111111111111111111111111111111111111111111111111111111111111111111111111111111111111111111111111111111111111111111111111111111111111111111111111111111111111111111111111111111111111111111111111111111111111111111111111111111111111111111111111111111111111111111111111111111111111111111111111111111111111111111111111111111111111111111111
100200000001
11E000000001                            
111111111111
1111111111111
1 11111111111
