F 94, 1, 1
C 1, 12, 36

NO textures/purplestone.xpm
SO textures/halloween.xpm
EA textures/eagle.xpm
WE textures/wood.xpm

1111111111111111111111111111111111111111111111111111111111111111111111111111111111111111111111111111111111111111111111111111111111111111111111111111111111111111111111111111111111111111111111111
11000000000000000000000000000000000000000000000000000000000000000000000000000000000000000000000000000000000000000000000000001111111111111111111111111111111111111111111111111111111111111111111111111111111111111
100000011101111111111111111111111111111111111111111111111111111111111111111111111111111111111111111111111111111111111111111111111111111111111111111111111111111111111111111111111111111111111111111111
10000000001
11E000000001                            
111111111111
1111111111111
1 11111111111
