R 500 500

F 94, 93, 91
C 1, 12, 36

S textures/sprite_3.xpm

NO textures/purplestone.xpm
SO textures/wall_3.xpm
EA textures/eagle.xpm
WE textures/wood.xpm

1111
1001
1N01
1111